$$$$$$$$$$$$$$$$$$$$$$$$$$$$$$$$$$$$$$$$
$......................................$
$......................................$
$.............+........................$
$......................................$
$.................................E....$
$......................................$
$......................................$
$......................................$
$......................................$
$.............................E........$
$.......U..............................$
$......................................$
$......................................$
$......................................$
$.................................E....$
$.............+........................$
$......................................$
$......................................$
$$$$$$$$$$$$$$$$$$$$$$$$$$$$$$$$$$$$$$$$