$$$$$$$$$$$$$$$$$$$$$$$$$$$$$$$$$$$$$$$$
$......................................$
$......................................$
$......................................$
$......................................$
$......................................$
$......................................$
$......................................$
$......................................$
$......................................$
$......................................$
$.......U..............................$
$......................................$
$......................................$
$......................................$
$......................................$
$......................................$
$......................................$
$......................................$
$$$$$$$$$$$$$$$$$$$$$$$$$$$$$$$$$$$$$$$$