$$$$$$$$$$$$$$$$$$$$$$$$$$$$$$$$$$$$$$$$
$......................................$
$......................................$
$......................................$
$......................................$
$......................................$
$......................................$
$......................................$
$......................................$
$......................................$
$......................................$
$.......U..............................$
$......................................$
$......................................$
$......................................$
$......................................$
$..............$.......................$
$..............$.................E.....$
$..............$.......................$
$$$$$$$$$$$$$$$$$$$$$$$$$$$$$$$$$$$$$$$$