$$$$$$$$$$$$$$$$$$$$$$$$$$$$$$$$$$$$$$$$
$......................................$
$.+..................................+.$
$......................................$
$......................................$
$......................................$
$......................................$
$......................................$
$......................................$
$......................................$
$......................................$
$.......U..............................$
$......................................$
$......................................$
$......................................$
$................$..$$$$$$$$$$$$$$$$$$$$
$................$...............E.....$
$................$...............E.....$
$................$...............E.....$
$$$$$$$$$$$$$$$$$$$$$$$$$$$$$$$$$$$$$$$$