$$$$$$$$$$$$$$$$$$$$$$$$$$$$$$$$$$$$$$$$
$......................................$
$......................................$
$......................................$
$......................................$
$......................................$
$......................................$
$....................+.................$
$......................................$
$......................................$
$.....................E................$
$.......U............E.................$
$.....................E................$
$......................................$
$......................................$
$......................................$
$......................................$
$......................................$
$......................................$
$$$$$$$$$$$$$$$$$$$$$$$$$$$$$$$$$$$$$$$$