$$$$$$$$$$$$$$$$$$$$$$$$$$$$$$$$$$$$$$$$
$......................................$
$......................................$
$......................................$
$......................................$
$......................................$
$.................H....................$
$......................................$
$......................................$
$......................................$
$......................................$
$..........U......+....................$
$......................................$
$......................................$
$......................................$
$......................................$
$.................H....................$
$......................................$
$......................................$
$$$$$$$$$$$$$$$$$$$$$$$$$$$$$$$$$$$$$$$$